{
    "xFields":10,
    "yFields":7,
    "mices":[{"x":7,"y":3,"direction":37}
    ],
    "cats":[{"x": 2, "y":4, "direction": 38 }, {"x": 5, "y":4, "direction": 38 }, {"x": 3, "y":4, "direction": 38 },{"x": 4, "y":4, "direction": 38}, {"x": 2, "y":4 , "direction": 38}],
    "holes":[{"x": 1, "y": 0}],
    "rockets":[{"x":8,"y":1}],
    "arrows":{"left":1,"right":0,"top":0,"bottom":1},
    "horizontalWalls": [
       [1, 1, 1, 1, 1, 1, 1, 1, 1, 1],
       [1, 0, 0, 0, 0, 0, 0, 0, 0, 0],
       [0, 0, 0, 0, 0, 0, 0, 0, 0, 0],
       [0, 0, 0, 0, 0, 0, 0, 0, 0, 0],
       [0, 0, 0, 0, 0, 0, 0, 0, 0, 0],
       [0, 0, 0, 0, 0, 0, 0, 0, 0, 0],
       [0, 0, 0, 0, 0, 0, 0, 0, 0, 1]
    ], 
    "verticalWalls": [
       [1, 0, 1, 1, 1, 1, 1, 1, 0, 0],
       [1, 0, 0, 0, 0, 0, 0, 0, 0, 0],
       [1, 0, 0, 0, 0, 0, 0, 0, 0, 0],
       [1, 0, 0, 0, 0, 0, 0, 0, 0, 0],
       [1, 1, 0, 0, 0, 0, 0, 0, 0, 0],
       [1, 1, 0, 0, 0, 0, 0, 0, 0, 0],
       [1, 1, 1, 1, 1, 1, 1, 0, 0, 0]
    ]    
}