{
    "xFields":16,
    "yFields":15,
    "mices":[
            {"x":1,"y":14,"direction":38}
    ],
    "cats":[
    ],
    "rockets":[{"x":5,"y":2}],
    "arrows":{"left":1,"right":1,"top":4,"bottom":2},
    "horizontalWalls":[
        [1,1,1,1,1,1,1,1,1,1,1,1,1,1,1,1],
        [0,1,1,1,0,1,1,1,1,1,1,1,1,1,1,1],
        [0,1,1,1,1,1,1,0,1,1,1,1,1,0,1,1],
        [0,1,1,1,1,1,1,1,1,1,1,1,1,0,1,1],
        [1,1,1,1,0,1,1,1,1,1,1,1,1,0,1,1],
        [1,1,1,1,1,1,1,1,0,1,1,1,0,1,1,1],
        [0,1,1,1,0,1,1,1,1,1,1,1,0,1,1,0],
        [1,0,1,1,1,1,1,1,1,1,1,1,1,0,1,0],
        [1,1,0,1,1,1,1,1,1,1,1,1,1,1,1,0],
        [1,1,1,1,0,1,0,1,1,1,1,1,1,1,1,0],
        [1,1,1,1,0,1,1,1,0,0,1,1,1,1,1,1],
        [0,1,1,1,1,1,1,1,0,1,0,1,1,1,1,1],
        [0,1,1,1,1,1,1,0,1,1,1,1,0,1,1,1],
        [0,1,1,1,1,0,1,1,1,1,1,1,1,1,1,0],
        [0,1,1,1,1,0,1,1,1,1,1,1,1,0,1,1]
    ],
    "verticalWalls":[
        [1,1,0,0,0,0,0,0,0,0,0,1,1,1,1,1],
        [1,1,0,0,0,0,0,0,0,0,1,1,1,1,1,1],
        [1,1,0,0,0,0,0,0,0,0,0,0,0,0,1,1],
        [1,0,0,0,0,0,0,0,0,0,1,1,1,1,1,1],
        [1,0,0,0,0,0,0,0,0,0,0,1,0,0,1,1],
        [1,1,0,0,0,0,0,0,0,0,0,1,0,0,0,0],
        [1,1,0,0,0,0,0,0,0,0,0,0,0,1,1,1],
        [1,1,0,0,0,0,0,0,0,0,0,1,1,1,1,1],
        [1,1,0,0,0,0,0,0,0,0,0,1,1,1,1,1],
        [1,0,0,0,0,0,0,0,0,0,0,0,0,0,0,0],
        [1,0,0,0,0,0,0,0,1,1,0,0,0,0,0,0],
        [1,1,0,0,0,0,0,0,0,0,0,1,0,0,0,0],
        [1,0,0,0,0,1,0,0,0,0,0,0,0,1,0,0],
        [1,1,0,0,0,0,0,0,0,0,0,1,1,0,0,0],
        [1,0,0,0,0,0,0,0,0,0,0,0,0,0,0,0]
    ]
}