{
    "xFields":11,
    "yFields":11,
    "mices":[
            {"x":0,"y":1,"direction":38},
            {"x":2,"y":0,"direction":38},
            {"x":2,"y":1,"direction":38},
            {"x":2,"y":2,"direction":38},
            {"x":2,"y":3,"direction":38},
            {"x":2,"y":4,"direction":38},
            {"x":2,"y":5,"direction":38},
            {"x":2,"y":6,"direction":38}
    ],
    "cats":[
    ],
    "rockets":[{"x":5,"y":2},{"x":5,"y":8}],
    "holes":[{"x":0,"y":0}],
    "arrows":{"left":1,"right":1,"top":0,"bottom":0},
    "horizontalWalls":[
        [1,1,1,0,0,0,0,0,0,0,0],
        [0,0,0,0,0,0,0,0,0,0,0],
        [0,0,0,0,0,0,0,0,0,0,0],
        [0,0,0,0,0,0,0,0,0,0,0],
        [1,0,0,0,0,0,1,1,0,0,0],
        [0,0,0,0,0,0,0,0,0,0,0],
        [1,0,0,0,0,0,0,0,0,0,0],
        [0,0,0,0,0,0,0,0,0,0,0],
        [0,0,0,0,0,0,0,0,0,0,0],
        [0,0,0,0,0,0,0,0,0,0,0],
        [0,0,0,0,0,0,0,0,0,0,0]
    ],
    "verticalWalls":[
        [1,0,1,1,0,0,0,0,0,0,0],
        [1,0,0,1,0,0,0,0,0,0,0],
        [1,0,0,1,0,0,0,0,0,0,0],
        [1,0,0,1,0,0,0,0,0,0,0],
        [1,0,0,0,0,0,1,0,0,0,0],
        [1,0,0,0,0,0,0,0,0,0,0],
        [1,0,0,1,0,0,0,0,0,0,0],
        [1,0,0,1,0,0,0,0,0,0,0],
        [1,0,0,1,0,0,0,0,0,0,0],
        [1,0,0,1,0,0,0,0,0,0,0],
        [1,0,1,1,0,0,0,0,0,0,0]
    ]
}